NO ./textures/ekko_alone.xpm
SO ./textures/ekko-et-powder-troll.xpm
WE ./textures/ekko-end.xpm
EA ./textures/ekko-et-powder-qui-dance.xpm

F 	 	 	 	 	128,128,128
C 				  135,206,250

11111111111111111111
10000000000000000001
10000000000000000001
1000001100N001100001
10000000000000000001
10000000000000000001
11111111111111111111
